R 12345678 12345678
NO         ./textures/north.xpm
     SO ./textures/south.xpm

   F 96,96,96


C 123,25,61

WE ./textures/west.xpm

EA ./textures/east.xpm
S ./textures/barrel.xpm



        1111111111111111111111111
        1000000000110000000000001
        1011000001110000000000001
        1001000000000000000000001
111111111011000001110002220000001
1000000000110000011101111100111111
11110111111111011100000010001
11110111111111011101010010001
11000000110101011100000012021
10000000000000001100000010001
10000000000000001101010010001
11000001110101011111011110N0111
11110111 1110101 101111010001
11111111 1111111 111111111111
